type octile
height 7
width 11
map
...........
...........
..L....L...
...........
........L..
..L........
...........