type octile
height 10
width 16
map
................
...@@@....@@L...
...L@@....L@@...
................
................
................
................
...@@@....L@@...
...L@@....@@@...
................
