type octile
height 21
width 22
map
......................
......................
........L.............
......................
......................
......................
..L...............L...
.......L..............
......................
......................
...............L......
......................
........L.............
...................L..
......................
....L.................
......................
.............L........
..L...................
......................
......................