type octile
height 32
width 32
map
................................
................................
................................
................................
.....L..........................
........................L.......
................................
................................
.......F........................
...............L................
................................
................................
........L...............L.......
................................
.................F..............
..L......................L......
...........L....................
................................
...............L.........L......
....L...........................
................................
................F...............
........................L.......
................................
......L.........................
....F...........................
.........................L......
................................
..L.............................
...............L................
................................
................................
